1 1 1 1 1 1 1 1 1 1 1 1 1 1 1 1
1 0 0 0 0 0 1 0 0 0 0 0 0 0 0 1
1 0 0 1 1 0 1 0 1 1 1 1 4 1 0 1
1 0 0 0 1 0 4 0 0 0 0 0 0 1 0 1
1 1 1 0 1 0 1 1 1 1 1 0 0 1 0 1
1 0 0 0 1 0 1 0 0 0 1 0 0 1 0 1
1 0 1 1 1 0 1 0 2 0 1 1 1 1 0 1
1 0 0 2 0 0 1 3 2 0 0 0 0 0 0 1
1 0 1 1 1 1 1 1 1 1 1 1 1 1 4 1
1 0 2 2 0 1 0 0 0 2 0 0 0 2 0 1
1 3 2 6 2 1 6 2 0 0 0 2 0 0 0 1
1 1 1 1 1 1 1 1 1 1 1 1 1 1 1 1
